"","time","elders","adults","children","total"
"1",10,2,2,8,12
"2",11,6,5,11,22
"3",12,4,8,9,21
"4",13,9,6,10,25
"5",14,8,10,11,29
"6",15,10,15,16,41
"7",16,13,18,18,49
"8",17,9,17,12,38
"9",18,6,20,9,35
"10",19,3,18,8,29
